#08#06
########
#P   T#
# B    #
#   T  #
#    B #
########