#16#14
################
#              #
# ############ #
# #T  T  T  T# #
# #          # #
# # B  #  #  # #
# #    #  #  # #
# # B  #  # B# #
# #    #  #  # #
# # B  #  # B# #
# #    #  #  # #
# #          # #
# #T  T  TP T# #
# ############ #
################