#10#08
##########
#P       #
# B  #   #
#    # T #
# B  # T #
#    #   #
#  B   T #
##########