#14#12
##############
#            #
#  ######### #
#  #T T T T# #
#  #       # #
#  # B B B # #
#  #   P   # #
#  # B B B # #
#  #       # #
#  #T T T T# #
#  ######### #
##############