#12#10
############
#          #
# ###  ### #
# #T    T# #
# # B  B # #
# #      # #
# # B  B # #
# #T    T# #
# ###P ### #
############